Address,YearBuilt,TotalLivingArea,FirstFloor,SecondFloor,ThirdFloor,Basement,FinishedBasement,LotSize
10008 Watts Rd,2019,1880,978,902,0,978,0,6475.0
10012 Watts Rd,2019,1572,1572,0,0,1572,0,6475.0
10016 Watts Rd,2019,2124,1122,1002,0,1122,0,6468.0
10020 Watts Rd,2019,2156,1124,1032,0,1124,0,7518.0
10023 Watts Rd,2019,2033,994,1039,0,994,0,8587.0
10024 Watts Rd,2020,1764,1764,0,0,1764,607,7489.0
101 North Star Dr,2019,1389,742,647,0,728,0,7302.0
10102 Watts Rd,2019,2056,1068,988,0,1068,0,6417.0
10106 Watts Rd,2019,1576,1576,0,0,1572,0,6991.0
10110 Watts Rd,2019,1604,1604,0,0,1604,844,7198.0
10114 Watts Rd,2019,1580,1580,0,0,1572,0,7101.0
10118 Watts Rd,2019,1482,1482,0,0,1482,0,7194.0
10121 White Fox Ln,2019,2013,2013,0,0,2013,703,7210.0
10122 Watts Rd,2019,1879,981,898,0,978,0,9428.0
10125 White Fox Ln,2019,2616,1596,1020,0,1596,833,7128.0
10129 White Fox Ln,2019,2455,1188,1267,0,1188,810,7432.0
102 North Star Dr,2019,1492,756,736,0,742,275,6510.0
10202 Sister Oak Dr,2020,2172,1108,1064,0,1108,0,6956.0
10202 Sleepy Pine Rdg,2020,1712,1712,0,0,1712,368,5364.0
10203 Watts Rd,2019,1733,1733,0,0,1733,0,7217.0
10204 Watts Rd,2019,1695,1695,0,0,1695,0,7984.0
10206 Sleepy Pine Rdg,2020,1720,1720,0,0,1720,0,4731.0
10207 Watts Rd,2019,1719,1719,0,0,1719,0,4689.0
10207 White Fox Ln,2019,2461,1309,1152,0,1309,0,6582.0
10208 Watts Rd,2019,1866,1866,0,0,1866,0,5460.0
10210 Shady Birch Trl,2019,2045,1006,1039,0,1006,0,7161.0
10210 Sister Oak Dr,2020,1812,1812,0,0,1812,0,7379.0
10210 Sleepy Pine Rdg,2020,1372,1372,0,0,1372,0,3993.0
10211 Watts Rd,2019,1717,1717,0,0,1717,0,4166.0
10212 Watts Rd,2019,1866,1866,0,0,1866,0,5460.0
10213 Sister Oak Dr,2020,1502,763,739,0,763,0,7266.0
10214 Sister Oak Dr,2020,2404,1220,1184,0,1212,0,6500.0
10214 Sleepy Pine Rdg,2020,1372,1372,0,0,1372,0,3182.0
10215 Watts Rd,2019,1717,1717,0,0,1713,0,3943.0
10216 Shady Birch Trl,2019,2396,1212,1184,0,1212,0,7402.0
10216 Watts Rd,2019,1690,1690,0,0,1690,0,5760.0
10218 Sister Oak Dr,2020,2134,1132,1002,0,1128,0,5900.0
10218 Sleepy Pine Rdg,2020,1692,1692,0,0,1692,0,3753.0
10219 Watts Rd,2019,1372,1372,0,0,1372,0,3324.0
10220 Watts Rd,2019,1697,1697,0,0,1697,0,5760.0
10221 Sister Oak Dr,2020,1519,777,742,0,777,0,6598.0
10222 Sleepy Pine Rdg,2020,1726,1726,0,0,1726,0,4991.0
10223 Watts Rd,2019,1372,1372,0,0,1372,0,3324.0
10224 Watts Rd,2019,1866,1866,0,0,1866,0,5460.0
10227 Watts Rd,2020,1700,1700,0,0,1700,0,3920.0
10228 Watts Rd,2019,1866,1866,0,0,1866,0,5460.0
10231 Watts Rd,2020,1720,1720,0,0,1720,0,4368.0
10232 Watts Rd,2019,1697,1697,0,0,1697,0,5760.0
10236 Watts Rd,2019,1711,1711,0,0,1711,0,5760.0
10240 Watts Rd,2019,1886,1886,0,0,1886,0,5460.0
10244 Watts Rd,2019,2034,2034,0,0,2034,0,5460.0
10248 Watts Rd,2019,1674,1674,0,0,1674,0,5760.0
103 North Star Dr,2019,1439,742,697,0,728,0,4016.0
10301 Quiet Leaf Dr,2020,1764,1764,0,0,1764,0,6996.0
10302 Hazy Sky Pkwy,2019,1815,917,898,0,911,329,6627.0
10303 Sister Oak Dr,2020,2052,1006,1046,0,1006,0,9097.0
10304 Ivory Dove Trl,2019,1826,1826,0,0,1826,511,9388.0
10304 Sister Oak Dr,2020,1848,964,884,0,964,704,7003.0
10305 Quiet Leaf Dr,2020,2045,1006,1039,0,1006,527,6500.0
10306 Hazy Sky Pkwy,2020,1885,978,907,0,978,0,6428.0
10306 White Fox Ln,2019,1519,777,742,0,777,0,6202.0
10307 Ivory Dove Trl,2019,1592,1592,0,0,1592,0,6136.0
10307 Shady Birch Trl,2019,2656,1524,1132,0,1524,458,7590.0
10308 Ivory Dove Trl,2019,2045,1006,1039,0,1006,550,10878.0
1031 Vilas Ave,2020,2907,1254,1653,0,1254,0,3845.0
10310 White Fox Ln,2019,1879,981,898,0,978,391,6136.0
10311 Ivory Dove Trl,2019,1608,1608,0,0,1604,0,6136.0
10312 Shady Birch Trl,2019,2204,1124,1080,0,1124,0,6900.0
10314 White Fox Ln,2019,1880,982,898,0,982,0,6404.0
10315 Ivory Dove Trl,2019,2284,1230,1054,0,1230,0,6540.0
10315 Shady Birch Trl,2019,2204,1124,1080,0,1124,0,7590.0
10315 Sister Oak Dr,2020,1620,1620,0,0,1620,1106,6500.0
10316 Shady Birch Trl,2019,1841,1841,0,0,1841,889,8265.0
10318 White Fox Ln,2019,1898,962,936,0,962,0,6424.0
10319 Ivory Dove Trl,2019,2156,1148,1008,0,1148,750,7335.0
10320 Sister Oak Dr,2020,2446,1188,1258,0,1188,0,5900.0
10322 White Fox Ln,2019,1848,964,884,0,964,0,5899.0
10323 Ivory Dove Trl,2019,2043,1093,950,0,1090,0,6200.0
10324 Ivory Dove Trl,2019,2052,1006,1046,0,1006,566,6885.0
10326 White Fox Ln,2019,1864,964,900,0,964,0,6200.0
10328 Sister Oak Dr,2020,1848,964,884,0,964,0,5900.0
1033 Vilas Ave,2020,1889,749,1140,0,734,510,3208.0
10330 White Fox Ln,2019,2396,1212,1184,0,1212,0,6500.0
10334 White Fox Ln,2019,2446,1188,1258,0,1188,0,6500.0
104 North Star Dr,2019,1492,756,736,0,742,0,3544.0
10404 White Fox Ln,2020,1822,917,905,0,917,0,7403.0
10407 Hollow Aspen Ln,2019,2396,1212,1184,0,1212,0,14234.0
10408 White Fox Ln,2020,2056,1068,988,0,1068,0,6935.0
10412 White Fox Ln,2019,1764,1764,0,0,1764,0,6935.0
105 North Star Dr,2020,1486,753,733,0,753,0,4067.0
106 North Star Dr,2019,1474,756,718,0,742,0,3544.0
107 Galileo Dr,2020,2211,1132,1079,0,1124,0,8430.0
107 North Star Dr,2020,1486,753,733,0,753,0,4793.0
108 North Star Dr,2019,1474,756,718,0,742,0,4135.0
1104 Red Rock Ln,2019,3904,2173,1731,0,2173,1392,14563.0
1108 Red Rock Ln,2020,3145,1609,1536,0,1609,1173,13639.0
1118 Southridge Ct,2020,2695,2695,0,0,2084,2084,46752.0
1213 Droster Rd,2019,1352,1352,0,0,1352,0,17000.0
1218 Blue Stone Ter,2020,2652,1312,1340,0,1312,0,8421.0
1222 Blue Stone Ter,2020,2405,1301,1104,0,1301,0,10172.0
1224 Brunette Downs Dr,2020,2437,1317,1120,0,1317,0,5799.0
1228 Brunette Downs Dr,2020,1971,1971,0,0,1971,0,5800.0
1232 Brunette Downs Dr,2020,2316,1334,982,0,1334,772,6151.0
127 Galileo Dr,2020,1851,1851,0,0,1851,834,8120.0
1302 Brunette Downs Dr,2019,2488,1144,1344,0,1144,0,6605.0
131 Galileo Dr,2020,2006,2006,0,0,2006,0,8119.0
1310 Brunette Downs Dr,2020,1504,748,756,0,748,0,8051.0
1313 Black Stallion Dr,2020,2117,2117,0,0,2117,0,9000.0
1316 Black Stallion Dr,2019,2154,2154,0,0,2154,1482,8760.0
1317 Black Stallion Dr,2020,2329,1293,1036,0,1293,0,9000.0
1318 Brunette Downs Dr,2020,2245,1125,1120,0,1125,0,7200.0
1322 Brunette Downs Dr,2019,2513,1324,1189,0,1324,0,7200.0
1322 Chandler St,2019,2749,1594,1155,0,1594,0,7950.0
1324 Black Stallion Dr,2020,1982,1982,0,0,1982,1398,8760.0
1326 Crowley Ave,2019,1818,909,909,0,1818,0,4800.0
1330 Crowley Ave,2020,1818,909,909,0,909,0,4800.0
1334 Crowley Ave,2020,1818,909,909,0,909,0,4750.0
140 North Star Dr,2019,1638,838,800,0,822,0,3917.0
1402 Black Stallion Dr,2019,2159,980,1179,0,980,0,8760.0
1406 Black Stallion Dr,2019,2138,2138,0,0,2138,1925,9731.0
1410 Black Stallion Dr,2019,1925,1925,0,0,1925,1143,8965.0
144 North Star Dr,2019,1520,782,738,0,772,0,3504.0
148 North Star Dr,2019,1532,788,744,0,788,0,3504.0
152 North Star Dr,2020,1532,788,744,0,788,0,3504.0
1521 Burning Wood Way,2019,2410,2410,0,0,2392,2320,21579.0
156 North Star Dr,2019,1526,782,744,0,772,0,3983.0
1612 Twilight Trl,2020,1966,1966,0,0,1966,747,8762.0
1630 Adams St,2019,2154,1334,820,0,1405,773,4800.0
1722 Legacy Ln,2019,1493,1493,0,0,1482,988,5258.0
1724 Legacy Ln,2019,1733,1733,0,0,1725,999,6616.0
18 Prairie Hill Ct,2020,3819,1668,2151,0,1668,0,24564.0
1802 Legacy Ln,2019,1450,1450,0,0,1464,1020,5261.0
1803 Waterfall Way,2019,1672,978,694,0,978,0,6352.0
1804 Legacy Ln,2019,1482,1482,0,0,1472,980,5749.0
1804 Waterfall Way,2019,1503,763,740,0,763,0,6480.0
1807 Pipers Brook Dr,2019,2056,1073,983,0,1068,0,7285.0
1807 Waterfall Way,2019,1881,978,903,0,978,0,5900.0
1808 Waterfall Way,2020,1584,1584,0,0,1584,0,6018.0
1810 Pipers Brook Dr,2019,1848,964,884,0,964,0,7038.0
1811 Autumn Lake Pkwy,2019,1656,1656,0,0,1656,0,5250.0
1811 Pipers Brook Dr,2019,1848,964,884,0,964,0,7257.0
1811 Waterfall Way,2020,2056,1068,988,0,1068,0,12862.0
1812 Autumn Lake Pkwy,2019,1785,932,853,0,932,0,5250.0
1812 Waterfall Way,2020,1572,1572,0,0,1572,0,6018.0
1812 Willow Rock Rd,2019,1814,916,898,0,910,0,4506.0
1813 Willow Rock Rd,2020,1848,964,884,0,964,0,6431.0
1814 Pipers Brook Dr,2019,1552,1552,0,0,1552,0,7038.0
1815 Autumn Lake Pkwy,2019,1800,902,898,0,902,0,5670.0
1815 Waterfall Way,2020,1660,838,822,0,838,0,16373.0
1816 Autumn Lake Pkwy,2019,1532,782,750,0,772,0,4725.0
1816 Waterfall Way,2020,2092,1086,1006,0,1086,0,6348.0
1816 Willow Rock Rd,2020,2056,1068,988,0,1068,0,5900.0
1817 Willow Rock Rd,2019,1638,828,810,0,828,0,6431.0
1818 Pipers Brook Dr,2019,1482,1482,0,0,1482,0,7245.0
1819 Autumn Lake Pkwy,2019,1504,1504,0,0,1504,0,4725.0
1820 Autumn Lake Pkwy,2019,1708,1708,0,0,1708,0,4725.0
1820 Willow Rock Rd,2019,1511,773,738,0,763,0,6000.0
1821 Willow Rock Rd,2020,1876,978,898,0,978,0,7194.0
1822 Pipers Brook Dr,2019,1482,1482,0,0,1482,0,6107.0
1823 Autumn Lake Pkwy,2019,1785,932,853,0,932,0,3885.0
1823 Waterfall Way,2020,1519,777,742,0,777,0,21761.0
1824 Autumn Lake Pkwy,2019,1552,798,754,0,788,0,4725.0
1824 Waterfall Way,2020,1416,1416,0,0,1416,0,7045.0
1824 Willow Rock Rd,2019,1580,1580,0,0,1572,0,6000.0
1825 Willow Rock Rd,2020,1864,1864,0,0,1864,0,10129.0
1826 Pipers Brook Dr,2019,1482,1482,0,0,1482,0,6107.0
1827 Autumn Lake Pkwy,2019,1776,908,868,0,902,0,4725.0
1827 Twin Fawn Trl,2020,2087,1085,1002,0,1085,0,6000.0
1827 Waterfall Way,2020,1482,1482,0,0,1482,0,19833.0
1828 Autumn Lake Pkwy,2019,1818,920,898,0,920,0,4725.0
1828 Willow Rock Rd,2019,1764,1764,0,0,1764,0,6500.0
1831 Autumn Lake Pkwy,2019,1542,788,754,0,788,0,4725.0
1832 Autumn Lake Pkwy,2019,1784,932,852,0,932,0,4725.0
1832 Waterfall Way,2020,1482,1482,0,0,1482,0,6863.0
1835 Autumn Lake Pkwy,2019,1813,908,905,0,902,0,4725.0
1835 Waterfall Way,2020,2086,1085,1001,0,1085,0,16660.0
1836 Autumn Lake Pkwy,2019,1552,798,754,0,788,0,4725.0
1839 Autumn Lake Pkwy,2019,1510,772,738,0,772,172,4725.0
1840 Autumn Lake Pkwy,2019,1710,872,838,0,872,0,4725.0
1843 Autumn Lake Pkwy,2019,1628,828,800,0,822,0,4725.0
1844 Autumn Lake Pkwy,2019,1660,1660,0,0,1660,0,4725.0
1847 Autumn Lake Pkwy,2019,1656,1656,0,0,1656,0,5832.0
1903 Goshawk Ln,2019,1793,1793,0,0,1793,841,9428.0
1903 Waterfall Way,2020,1848,964,884,0,964,0,14479.0
1904 Tennyson Ln,2019,1036,1036,0,0,1036,0,8715.0
1904 Waterfall Way,2020,2076,1088,988,0,1088,0,6352.0
1907 Goshawk Ln,2019,2452,1217,1235,0,1217,0,8713.0
1907 Waterfall Way,2020,1572,1572,0,0,1572,0,15729.0
1908 Tennyson Ln,2019,1008,1008,0,0,1008,0,8750.0
1908 Waterfall Way,2020,1792,1792,0,0,1792,829,6900.0
1911 Goshawk Ln,2019,2259,2259,0,0,2259,1064,9622.0
1911 Waterfall Way,2020,2872,1472,1400,0,838,684,15058.0
1912 Tennyson Ln,2019,864,864,0,0,864,0,8750.0
1913 Raptor Dr,2019,1904,1904,0,0,1904,0,8670.0
1915 Goshawk Ln,2020,1974,1974,0,0,1974,1279,9365.0
1915 Swainson Dr,2019,1804,1804,0,0,1804,350,10190.0
1915 Waterfall Way,2020,1896,960,936,0,960,0,12513.0
1916 Goshawk Ln,2019,1816,1816,0,0,1816,1310,10777.0
1919 Goshawk Ln,2019,2407,1235,1172,0,1235,544,11165.0
201 Galileo Dr,2020,2372,1254,1118,0,1254,0,14788.0
202 North Star Dr,2020,1815,917,898,0,917,504,8351.0
206 North Star Dr,2020,1572,1572,0,0,1572,0,7077.0
218 Milky Way,2020,1876,978,898,0,978,0,7915.0
228 Little Bear Dr,2019,2121,1051,1070,0,1051,0,8018.0
2415 Allied Dr,2019,1041,1041,0,0,1033,0,3600.0
2418 Dunns Marsh Ter,2019,1508,754,754,0,743,0,6848.0
2423 Allied Dr,2019,1033,1033,0,0,1033,0,3600.0
2500 Waunona Way,2019,2950,1598,1352,0,1592,0,11775.0
2707 Van Hise Ave,2019,2745,1265,1480,0,1273,790,5955.0
28 N Baldwin St,2019,2124,1062,1062,0,1062,702,5022.0
2946 Stevens St,2019,1463,829,634,0,829,0,4254.0
301 E Dean Ave,2019,1748,1748,0,0,1821,825,26750.0
302 Milky Way,2020,2092,1090,1002,0,1082,0,7965.0
304 S Baldwin St,2019,1530,766,764,0,754,534,3369.0
305 Milky Way,2020,1482,1482,0,0,1482,871,6665.0
306 Milky Way,2020,2056,1068,988,0,1068,0,7965.0
309 Venus Way,2019,3345,1769,1576,0,1769,0,9938.0
310 Milky Way,2020,1502,763,739,0,763,0,7965.0
313 Venus Way,2019,2248,2248,0,0,2248,0,9525.0
3132 Lakeland Ave,2019,1949,1027,922,0,778,637,4384.0
314 Milky Way,2020,1651,839,812,0,828,0,8591.0
317 Milky Way,2020,1648,838,810,0,838,0,6058.0
318 Milky Way,2020,1511,773,738,0,773,0,8591.0
320 Venus Way,2019,1976,1021,955,0,1021,0,6900.0
321 Milky Way,2020,1482,1482,0,0,1482,0,5785.0
321 Venus Way,2019,1897,1897,0,0,1897,550,9533.0
322 Milky Way,2020,1519,777,742,0,777,0,7965.0
325 Venus Way,2019,1752,1752,0,0,1742,0,9536.0
327 Galileo Dr,2019,2440,1192,1248,0,1192,586,6900.0
328 Venus Way,2019,2042,1006,1036,0,1006,0,6900.0
331 Galileo Dr,2019,2396,1212,1184,0,1212,0,7558.0
3606 Margaret St,2019,1848,947,901,0,947,947,10973.33
37 N Bryan St,2019,766,428,338,0,428,300,3408.0
3714 Olbrich Ave,2019,2079,1136,943,0,1126,0,7400.0
3806 Eliot Ln,2020,1,1,0,0,1,0,6006.0
3809 Eliot Ln,2019,955,955,0,0,955,555,9650.0
3809 Ridgeway Ave,2019,1526,1526,0,0,1526,516,8645.0
3814 Eliot Ln,2020,960,960,0,0,680,0,6962.0
3818 Eliot Ln,2020,1160,1160,0,0,1160,400,6542.0
3822 Eliot Ln,2020,960,960,0,0,680,0,6521.0
3826 Eliot Ln,2019,1026,1026,0,0,1026,0,6289.0
4017 Euclid Ave,2019,1928,1928,0,0,1928,1273,6000.0
404 Galileo Dr,2019,1983,975,1008,0,975,0,7769.0
405 Engelhart Dr,2020,1456,672,784,0,672,0,7021.0
408 Galileo Dr,2019,1776,1776,0,0,1776,0,7441.0
409 Engelhart Dr,2019,1453,1453,0,0,1453,394,7732.0
409 S Mills St,2019,2385,994,1391,0,980,0,3085.0
409 Venus Way,2019,2045,1006,1039,0,1006,531,9291.0
411 S Mills St,2019,2385,994,1391,0,980,0,3088.0
419 Windy Peak Rd,2019,2400,1208,1192,0,1208,0,9085.0
42 Stacy Ln,2019,2155,2155,0,0,2155,828,11541.0
421 Blue Moon Dr,2019,2000,2000,0,0,2000,934,11850.0
421 Lush Woods Trl,2020,1848,964,884,0,964,0,6313.0
4214 Doncaster Dr,2019,1373,1373,0,0,1373,964,4800.0
4216 Doncaster Dr,2019,1450,730,720,0,720,0,4800.0
422 Venus Way,2019,2052,1006,1046,0,1006,0,6966.0
423 Milky Way,2019,1564,1564,0,0,1564,0,9129.0
423 Windy Peak Rd,2019,1974,1974,0,0,1974,0,10354.0
4234 Sheffield Rd,2019,1419,1419,0,0,0,0,6000.0
424 Milky Way,2019,1984,1006,978,0,1006,0,6500.0
425 Lush Woods Trl,2020,1650,828,822,0,828,0,6313.0
426 Blue Moon Dr,2019,2922,1613,1309,0,1613,0,11641.0
426 Lush Woods Trl,2020,1580,1580,0,0,1572,0,6032.0
426 Orion Trl,2020,1876,978,898,0,978,0,7086.0
426 Windy Peak Rd,2019,2045,1006,1039,0,1006,0,13087.0
427 Milky Way,2020,1627,1627,0,0,161,0,8650.0
427 Windy Peak Rd,2019,2414,1229,1185,0,1229,0,17194.0
428 Milky Way,2020,1572,1572,0,0,1572,0,6500.0
429 Blue Moon Dr,2019,2805,1401,1404,0,1401,0,11850.0
429 Lush Woods Trl,2020,1880,982,898,0,978,0,7685.0
429 Orion Trl,2019,1482,1482,0,0,1482,0,6894.0
430 Lush Woods Trl,2020,1974,1974,0,0,1974,0,8275.0
430 Orion Trl,2019,1746,1746,0,0,1746,0,7716.0
4301 Maher Ave,2019,1995,860,860,275,860,112,5433.0
4307 Bellgrove Ln,2019,4304,2216,2088,0,2216,0,13125.0
431 Milky Way,2019,1896,1896,0,0,1896,0,13000.0
4311 Bellgrove Ln,2020,4858,2453,2405,0,2453,0,15725.0
432 Milky Way,2019,1848,964,884,0,964,407,6857.0
433 Lush Woods Trl,2020,2092,1086,1006,0,1082,0,9400.0
433 Orion Trl,2019,1570,780,790,0,780,0,7255.0
435 Tawny Elm Pkwy,2020,2446,1188,1258,0,1188,0,7560.0
436 Milky Way,2019,1580,1580,0,0,1572,1112,7780.0
436 Tawny Elm Pkwy,2019,2056,1068,988,0,1068,0,7086.0
437 N Sugar Maple Ln,2019,2052,1006,1046,0,1006,0,6500.0
438 N Sugar Maple Ln,2019,1482,1482,0,0,1482,0,6018.0
439 N Sugar Maple Ln,2019,1967,1967,0,0,1967,0,6500.0
441 Blue Moon Dr,2019,2212,1128,1084,0,1124,0,12482.0
442 N Sugar Maple Ln,2019,1503,763,740,0,763,0,6018.0
443 N Sugar Maple Ln,2019,2731,1549,1182,0,1549,0,6500.0
444 Venus Way,2019,2204,1124,1080,0,1124,0,7006.0
446 Hercules Trl,2020,1660,838,822,0,838,0,5439.0
446 N Sugar Maple Ln,2020,2056,1068,988,0,1068,0,7551.0
447 N Sugar Maple Ln,2020,2092,1086,1006,0,1082,0,6500.0
450 Hercules Trl,2019,1503,763,740,0,763,0,5377.0
4800 Buckeye Rd,2019,1568,832,736,0,832,500,9275.0
4918 Lake Mendota Dr,2020,4534,2408,2126,0,2408,1601,19965.0
501 N Sugar Maple Ln,2020,1974,1974,0,0,1974,0,6500.0
503 Hercules Trl,2019,1511,773,738,0,763,0,5808.0
503 Orion Trl,2019,1848,964,884,0,964,0,5808.0
503 Tawny Elm Pkwy,2020,1880,978,902,0,978,0,8021.0
504 Hercules Trl,2019,1482,1482,0,0,1482,0,5391.0
504 Milky Way,2020,2092,1086,1006,0,1086,0,5815.0
504 Orion Trl,2019,1740,1740,0,0,1740,0,5808.0
504 Tawny Elm Pkwy,2019,2491,1224,1267,0,1224,0,7532.0
505 Orion Trl,2019,1580,790,790,0,780,0,5714.0
506 Milky Way,2019,1503,763,740,0,763,0,5748.0
507 Tawny Elm Pkwy,2019,1620,1620,0,0,1620,0,6364.0
508 Tawny Elm Pkwy,2020,1815,917,898,0,911,0,7281.0
509 N Sugar Maple Ln,2020,1841,1841,0,0,1841,0,6500.0
510 N Sugar Maple Ln,2019,2400,1212,1188,0,1212,0,6500.0
511 Tawny Elm Pkwy,2020,1572,1572,0,0,1572,0,5900.0
5119 Spring Ct,2019,2189,1907,282,0,1595,1054,8167.0
513 N Sugar Maple Ln,2020,2400,1208,1192,0,1208,0,6739.0
514 Dragon Willow Ln,2020,2944,1539,1405,0,1539,699,11646.0
515 Tawny Elm Pkwy,2020,1812,1812,0,0,1812,445,5900.0
516 Noble Oak Run,2019,1848,964,884,0,964,0,7258.0
517 N Sugar Maple Ln,2019,1619,1619,0,0,1615,0,7135.0
517 Sugar Maple Ln,2019,1650,828,822,0,828,483,11350.0
518 N Sugar Maple Ln,2019,2444,1186,1258,0,1186,602,7084.0
519 Tawny Elm Pkwy,2020,2084,1082,1002,0,1082,678,6500.0
520 Noble Oak Run,2019,1503,763,740,0,763,663,5905.0
520 Tawny Elm Pkwy,2020,1841,1841,0,0,1841,0,10402.0
5201 Perfect Dr,2019,1771,1771,0,0,1771,1346,10136.0
521 Sugar Maple Ln,2019,1554,763,791,0,763,0,8451.0
522 N Sugar Maple Ln,2019,2045,1006,1039,0,1006,598,6864.0
523 Tawny Elm Pkwy,2019,1650,828,822,0,828,0,7068.0
5232 Perfect Dr,2020,2318,2318,0,0,2318,1450,10453.0
524 Noble Oak Run,2019,1898,929,969,0,929,0,5900.0
524 Tawny Elm Pkwy,2020,3007,1541,1466,0,1541,0,15234.0
525 Burnt Sienna Dr,2019,3593,1859,1734,0,1916,1276,12469.0
525 Dragon Willow Ln,2019,2081,2081,0,0,2081,0,13881.0
525 Stone Arbor Trl,2020,2056,1068,988,0,1068,0,7952.0
525 Sugar Maple Ln,2019,1482,1482,0,0,1482,1082,7863.0
525 Wingra St,2019,1745,1133,612,0,1133,0,3360.0
526 Dragon Willow Ln,2019,1642,1642,0,0,1642,791,12373.0
526 N Sugar Maple Ln,2019,2286,1247,1039,0,1247,0,6864.0
528 Tawny Elm Pkwy,2019,3251,1673,1578,0,1673,0,12849.0
529 Sugar Maple Ln,2019,1848,964,884,0,964,437,6978.0
529 Woodward Dr,2019,4137,2182,1955,0,3055,2517,13530.0
530 N Sugar Maple Ln,2019,2045,1006,1039,0,1006,0,5736.0
5303 Hoboken Rd,2019,893,893,0,0,914,0,24975.0
531 Feather Sound Dr,2020,1519,777,742,0,777,0,7358.0
531 Stone Arbor Trl,2020,1578,1578,0,0,1578,0,6549.0
532 Morningstar Ln,2020,2160,2160,0,0,2160,0,10575.0
532 Roman Mist Way,2019,2045,1006,1039,0,1006,0,7514.0
532 Tawny Elm Pkwy,2019,3030,1666,1364,0,1666,0,10516.0
534 N Sugar Maple Ln,2019,2035,996,1039,0,996,0,5653.0
536 Burnt Sienna Dr,2019,2152,2152,0,0,2152,1543,9237.0
536 Tawny Elm Pkwy,2020,3016,1408,1608,0,1408,0,10609.0
537 Burnt Sienna Dr,2019,2748,1401,1347,0,1385,840,12057.0
537 Roman Mist Way,2019,1650,828,822,0,828,0,6717.0
537 Rustic Rise Way,2020,2782,1391,1391,0,1391,0,11743.0
538 N Sugar Maple Ln,2019,2132,1128,1004,0,1128,0,5420.0
538 Rustic Rise Way,2020,1805,1805,0,0,1797,0,11910.0
538 Stone Arbor Trl,2020,1482,1482,0,0,1482,183,5800.0
54 Merlham Dr,2020,1984,1984,0,0,1480,950,8375.0
541 Burnt Sienna Dr,2019,2415,1333,1082,0,1344,866,11216.0
543 Roman Mist Way,2020,2088,1086,1002,0,1086,0,5800.0
543 Stone Arbor Trl,2020,1416,1416,0,0,1416,30,5661.0
5438 Lake Mendota Dr,2019,3680,2340,1340,0,2324,1180,16533.0
544 Stone Arbor Trl,2020,1412,1412,0,0,1412,0,4987.0
545 Burnt Sienna Dr,2019,2051,2051,0,0,2033,1239,9821.0
5450 Lake Mendota Dr,2019,2856,1320,1536,0,1529,892,13157.56
548 Burnt Sienna Dr,2019,2104,2104,0,0,20196,0,11480.0
549 Roman Mist Way,2019,1848,964,884,0,964,0,5800.0
5512 Levitan Ln,2020,1910,938,972,0,932,0,5015.0
5514 Spring Tide Way,2020,1484,752,732,0,1470,0,3215.0
5516 Levitan Ln,2020,2088,1086,1002,0,1082,0,5015.0
5516 Spring Tide Way,2020,1484,752,732,0,1470,0,3215.0
5518 Spring Tide Way,2020,1520,754,766,0,754,0,3215.0
5519 Levitan Ln,2020,1502,763,739,0,763,0,5900.0
5520 Spring Tide Way,2020,1520,754,766,0,754,0,5129.0
5523 Levitan Ln,2019,2045,1006,1039,0,1006,574,7002.0
5524 Levitan Ln,2020,1578,1578,0,0,1578,832,5015.0
555 Roman Mist Way,2019,1809,911,898,0,911,0,4987.0
5601 Rustic Pebble Ln,2019,2063,1064,999,0,1055,0,5832.0
5605 Rustic Pebble Ln,2020,1628,828,800,0,828,0,4033.0
5607 Levitan Ln,2020,1650,838,812,0,828,0,7734.0
5608 Levitan Ln,2020,2045,1006,1039,0,1006,0,6089.0
5609 Rustic Pebble Ln,2020,1578,808,770,0,808,0,4033.0
5611 Levitan Ln,2019,1848,964,884,0,964,0,5899.0
5612 Levitan Ln,2020,2189,1149,1040,0,1149,0,5561.0
5613 Rustic Pebble Ln,2019,1610,822,788,0,822,0,4033.0
5615 Levitan Ln,2020,2088,1086,1002,0,1082,0,5900.0
5616 Levitan Ln,2020,1980,1030,950,0,1030,0,5426.0
5632 Levitan Ln,2019,2045,1006,1039,0,1006,0,8050.0
5646 Lake Mendota Dr,2019,3618,1796,1822,0,1796,0,14810.5
5704 Levitan Ln,2019,2155,1132,1023,0,1022,0,7352.0
5708 Levitan Ln,2019,2502,1244,1258,0,1244,0,6900.0
5723 Summer Shine Dr,2019,1556,764,792,0,764,391,24104.0
5727 Summer Shine Dr,2019,1935,1021,914,0,998,0,28877.0
5728 Levitan Ln,2019,2400,1208,1192,0,1208,0,6900.0
5731 Summer Shine Dr,2019,2087,1085,1002,0,1081,0,24330.0
5816 Levitan Ln,2019,1841,1841,0,0,1841,0,7583.0
5820 Lien Rd,2019,1608,808,800,0,808,0,3804.0
5822 Lien Rd,2019,1608,808,800,0,808,0,3069.0
5826 Lien Rd,2019,1608,800,808,0,800,0,3046.0
5828 Lien Rd,2019,1608,800,808,0,800,0,2967.0
5832 Lien Rd,2019,1608,808,800,0,800,0,2866.0
5834 Lien Rd,2019,1608,808,800,0,800,0,2868.0
5838 Lien Rd,2019,1608,800,808,0,800,0,2821.0
5840 Lien Rd,2019,1608,800,808,0,800,0,2772.0
5844 Lien Rd,2019,1608,808,800,0,800,0,2725.0
5846 Lien Rd,2019,1608,808,800,0,800,0,2677.0
5850 Lien Rd,2019,1608,800,808,0,800,0,3133.0
5852 Lien Rd,2019,1608,800,808,0,800,0,3085.0
5856 Lien Rd,2019,1608,808,800,0,800,0,3037.0
5858 Lien Rd,2019,1608,808,800,0,800,0,2989.0
5862 Lien Rd,2019,1608,800,808,0,800,0,2941.0
5864 Lien Rd,2019,1608,800,808,0,800,0,2893.0
5868 Lien Rd,2020,1620,808,812,0,492,297,2843.0
5870 Lien Rd,2020,1620,808,812,0,492,297,2783.0
5874 Lien Rd,2020,1620,800,820,0,492,297,2722.0
5876 Lien Rd,2020,1620,800,820,0,492,297,2661.0
5880 Lien Rd,2020,1620,808,812,0,492,320,2880.0
5882 Lien Rd,2020,1620,808,812,0,492,297,2820.0
5886 Lien Rd,2020,1620,800,820,0,492,0,2758.0
5888 Lien Rd,2020,1620,800,820,0,492,0,2698.0
5926 Carter Moon Pass,2019,1466,1466,0,0,1466,0,6345.0
5930 Carter Moon Pass,2019,1519,777,742,0,777,0,5900.0
5934 Carter Moon Pass,2019,1809,911,898,0,911,0,8766.0
5938 Carter Moon Pass,2019,1883,985,898,0,978,0,6106.0
5942 Carter Moon Pass,2019,1638,828,810,0,828,0,5310.0
5946 Carter Moon Pass,2019,1847,1847,0,0,1847,0,7638.0
6002 Stoney Oak Ln,2020,1482,1482,0,0,1482,0,6099.0
6006 Stoney Oak Ln,2020,1547,1547,0,0,1547,0,6232.0
6007 Stoney Oak Ln,2020,1503,763,740,0,763,0,5959.0
6008 Lyda Woods Ln,2020,1519,780,739,0,780,318,5959.0
6009 Lyda Woods Ln,2020,1580,1580,0,0,1580,0,5965.0
601 Tawny Elm Pkwy,2019,1880,978,902,0,978,0,7163.0
6010 Stoney Oak Ln,2020,1502,763,739,0,763,0,6826.0
6012 Lyda Woods Ln,2020,2116,1114,1002,0,1114,668,5959.0
6013 Lyda Woods Ln,2020,1584,1584,0,0,1584,0,5965.0
6014 Stoney Oak Ln,2020,1650,838,812,0,828,0,7419.0
6015 Stoney Oak Ln,2020,2084,1082,1002,0,1082,0,5959.0
6016 Lyda Woods Ln,2020,1848,964,884,0,964,329,5959.0
6017 Lyda Woods Ln,2020,1848,964,884,0,964,0,5965.0
602 Jagged Pine Dr,2019,1848,964,884,0,964,0,7519.0
602 Old Timber Pass,2020,1720,1720,0,0,1720,0,7999.0
602 Schewe Rd,2019,1815,917,898,0,911,0,7089.0
6021 Lyda Woods Ln,2020,1555,789,766,0,789,0,5965.0
6024 Aries Way,2019,1841,1841,0,0,1841,0,7797.0
603 Jagged Pine Dr,2019,1764,1764,0,0,1764,691,7747.0
603 Morningside Ave,2019,1085,632,453,0,632,489,16113.0
603 Rustic Rise Way,2020,1848,964,884,0,964,0,7843.0
6039 Ragan St,2020,2116,1108,1008,0,1108,0,9583.0
604 Burnt Sienna Dr,2020,2045,2045,0,0,2045,0,10122.0
604 Rustic Rise Way,2020,2535,1349,1186,0,1349,0,12019.0
605 Sugar Maple Ln,2019,2080,1092,988,0,1092,655,6455.0
606 Jagged Pine Dr,2019,2056,1068,988,0,1068,422,6544.0
606 Old Timber Pass,2020,2034,2034,0,0,2034,0,6143.0
606 Schewe Rd,2019,1848,964,884,0,964,0,6728.0
607 Jagged Pine Dr,2019,2836,1605,1231,0,1605,0,6811.0
610 Jagged Pine Dr,2019,2438,1180,1258,0,1180,0,6802.0
610 Old Timber Pass,2020,1866,1866,0,0,1866,0,6143.0
610 Schewe Rd,2019,2088,1086,1002,0,1082,0,8309.0
6101 Driscoll Dr,2019,1708,1708,0,0,1708,0,5147.0
6103 Ragan St,2019,1763,1763,0,0,1752,0,6051.0
6104 Ragan St,2020,1648,838,810,0,838,0,5523.0
6105 Driscoll Dr,2019,1806,908,898,0,902,0,4275.0
6107 Kilpatrick Ln,2019,3047,1623,1424,0,1623,0,10515.0
6107 Ragan St,2020,1813,908,905,0,902,0,4220.0
6108 Ragan St,2019,1806,908,898,0,90,0,4265.0
6108 Saturn Dr,2019,1780,1038,742,0,1038,0,5048.0
6109 Driscoll Dr,2019,1542,788,754,0,788,0,4275.0
611 Jagged Pine Dr,2019,2567,1391,1176,0,1391,589,6811.0
6111 Ragan St,2020,1542,788,754,0,788,0,3515.0
6111 Saturn Dr,2019,1556,1556,0,0,1556,915,6667.0
6112 Ragan St,2020,1628,828,800,0,828,0,3515.0
6112 Saturn Dr,2019,1848,964,884,0,964,0,5015.0
6113 Driscoll Dr,2019,1648,838,810,0,822,0,3515.0
6114 Misty Bridge Rd,2020,1627,827,800,0,821,0,4275.0
6115 Ragan St,2019,1734,932,802,0,932,0,3515.0
6115 Saturn Dr,2019,1519,777,742,0,777,0,6667.0
6116 Ragan St,2020,1510,772,738,0,772,0,3515.0
6116 Saturn Dr,2019,1648,838,810,0,838,0,5015.0
6117 Driscoll Dr,2019,1510,782,728,0,772,0,3515.0
6119 Ragan St,2020,1638,838,800,0,822,390,3515.0
6119 Saturn Dr,2019,1482,1482,0,0,1482,0,6667.0
612 Burnt Sienna Dr,2020,2149,2149,0,0,2149,0,8750.0
6120 Ragan St,2020,1532,788,744,0,788,0,3515.0
6120 Saturn Dr,2019,1501,762,739,0,762,0,5031.0
6121 Driscoll Dr,2019,1522,788,734,0,788,0,3515.0
6123 Ragan St,2020,1546,795,751,0,795,0,3515.0
6124 Ragan St,2020,1525,765,760,0,765,0,3515.0
6125 Driscoll Dr,2019,1648,838,810,0,822,0,3515.0
6127 Ragan St,2020,1526,782,744,0,782,0,3515.0
6128 Ragan St,2020,1787,932,855,0,932,576,3515.0
6129 Driscoll Dr,2019,1464,756,708,0,746,0,3515.0
613 Silent Wind Rd,2019,2434,1169,1265,0,1169,0,7854.0
6131 Ragan St,2020,1520,782,738,0,782,0,3515.0
6132 Ragan St,2020,1541,797,744,0,778,549,3515.0
6133 Driscoll Dr,2019,1500,772,728,0,772,0,4275.0
6135 Ragan St,2020,1612,842,770,0,842,0,3515.0
6136 Ragan St,2020,1653,1653,0,0,1653,0,4275.0
6137 Driscoll Dr,2019,1648,838,810,0,828,0,3515.0
6139 Ragan St,2020,1510,772,738,0,772,310,3515.0
614 Old Timber Pass,2020,1664,1664,0,0,1664,0,6480.0
6140 Ragan St,2020,1526,785,741,0,785,0,3515.0
6141 Driscoll Dr,2019,1836,932,904,0,852,0,3515.0
6145 Driscoll Dr,2019,1540,796,744,0,788,502,3516.0
6147 Ragan St,2020,1617,846,771,0,846,0,3713.0
6149 Driscoll Dr,2019,1520,782,738,0,772,0,3543.0
615 Jagged Pine Dr,2019,2438,1256,1182,0,1256,0,7791.0
6153 Driscoll Dr,2019,1806,908,898,0,902,0,4416.0
6157 Driscoll Dr,2019,1532,788,744,0,788,0,4769.0
616 Silent Wind Rd,2019,1814,918,896,0,918,0,6885.0
6161 Driscoll Dr,2019,1656,1656,0,0,1656,0,4801.0
6165 Driscoll Dr,2019,1664,1664,0,0,1656,0,6398.0
6167 Ragan St,2020,1504,1504,0,0,1504,0,5022.0
617 Silent Wind Rd,2019,1524,1524,0,0,1524,0,6608.0
618 Old Timber Pass,2020,1720,1720,0,0,1720,0,6480.0
619 Stone Arbor Trl,2020,1552,798,754,0,798,0,4174.0
620 Burnt Sienna Dr,2020,2245,1151,1094,0,1151,0,8750.0
620 Silent Wind Rd,2019,1650,828,822,0,828,0,8910.0
6201 White Stag Pkwy,2019,2963,1578,1385,0,1578,0,9402.0
6205 White Stag Pkwy,2019,2262,1131,1131,0,1131,0,11492.0
6207 Driscoll Dr,2019,1841,1841,0,0,1841,0,6715.0
6207 Oasis Trl,2019,3248,1364,1884,0,1364,0,8080.0
6208 Oasis Trl,2019,2288,1144,1144,0,1144,0,14783.0
6209 White Stag Pkwy,2020,2240,1120,1120,0,1120,0,13500.0
621 Burnt Sienna Dr,2020,1735,866,869,0,866,537,8719.0
621 Silent Wind Rd,2019,2464,1198,1266,0,1198,0,7392.0
6211 Oasis Trl,2019,1789,1789,0,0,1789,0,7783.0
6214 Oasis Trl,2019,2460,1120,1340,0,1120,0,8864.0
6215 Oasis Trl,2019,2358,1188,1170,0,1188,0,7800.0
622 Old Timber Pass,2020,1866,1866,0,0,1866,632,6143.0
623 Stone Arbor Trl,2020,1510,772,738,0,772,0,4553.0
625 Burnt Sienna Dr,2019,2497,1196,1301,0,1196,0,9436.0
626 Old Timber Pass,2020,1640,1640,0,0,1640,0,6143.0
627 Old Timber Pass,2019,1717,1717,0,0,1713,0,5621.0
629 Burnt Sienna Dr,2020,2051,2051,0,0,2051,0,10174.0
629 Old Timber Pass,2019,1705,1705,0,0,1701,0,3903.0
630 Old Timber Pass,2020,1640,1640,0,0,1640,0,6480.0
633 Burnt Sienna Dr,2020,2397,1576,821,0,1576,0,11167.0
634 Old Timber Pass,2020,1720,1720,0,0,1720,0,6480.0
638 Old Timber Pass,2020,1866,1866,0,0,1866,728,6143.0
645 Old Timber Pass,2020,2008,1246,762,0,1246,0,3314.0
647 Old Timber Pass,2020,2008,1246,762,0,1246,0,3269.0
649 Burnt Sienna Dr,2020,1694,1694,0,0,1694,0,10301.0
650 Old Timber Pass,2020,1864,1864,0,0,1864,0,6143.0
654 Old Timber Pass,2020,1720,1720,0,0,1720,168,7106.0
702 Crimson Leaf Ln,2019,2416,1158,1258,0,1158,0,6510.0
703 Gingergrass Way,2019,1811,905,906,0,888,0,6779.0
703 Old Timber Pass,2020,1628,828,800,0,822,0,4782.0
704 Crimson Leaf Ln,2019,1645,833,812,0,828,0,5900.0
704 Gingergrass Way,2019,2454,1188,1266,0,1188,0,6500.0
707 Old Timber Pass,2020,1787,932,855,0,932,0,4590.0
708 Crimson Leaf Ln,2019,2056,1068,988,0,1068,868,5900.0
708 Gingergrass Way,2019,2213,1133,1080,0,1124,0,6500.0
709 Crimson Leaf Ln,2020,2045,1006,1039,0,1006,0,6500.0
711 Old Timber Pass,2020,1806,908,898,0,902,0,4590.0
712 Crimson Leaf Ln,2019,1572,1572,0,0,1572,0,5900.0
712 Old Timber Pass,2020,2446,1188,1258,0,1188,0,10743.0
713 Crimson Leaf Ln,2019,1879,981,898,0,978,0,6500.0
715 Old Timber Pass,2020,1520,782,738,0,782,0,4590.0
716 Crimson Leaf Ln,2019,1555,763,792,0,763,653,5900.0
716 Old Timber Pass,2020,1949,1949,0,0,1949,0,8632.0
717 Crimson Leaf Ln,2019,1554,1554,0,0,1554,0,6500.0
719 Old Timber Pass,2019,2062,1077,985,0,1067,0,4590.0
720 Crimson Leaf Ln,2019,1876,978,898,0,978,0,5903.0
720 Gingergrass Way,2019,2480,1222,1258,0,1222,0,6500.0
721 Crimson Leaf Ln,2019,1482,1482,0,0,1482,0,6500.0
722 Old Timber Pass,2020,1824,1824,0,0,1824,0,7503.0
723 Old Timber Pass,2020,1638,838,800,0,822,418,3773.0
724 Crimson Leaf Ln,2019,1511,773,738,0,763,0,5968.0
725 Crimson Leaf Ln,2019,2481,1296,1185,0,1296,0,6500.0
726 Old Timber Pass,2020,1974,1974,0,0,1974,1304,6883.0
727 Gingergrass Way,2019,2088,1086,1002,0,1082,0,7452.0
727 Old Timber Pass,2020,1958,1246,712,0,1246,0,3773.0
728 Crimson Leaf Ln,2019,1592,808,784,0,808,0,5231.0
729 Crimson Leaf Ln,2019,1991,1991,0,0,1991,0,6500.0
731 Old Timber Pass,2020,1787,932,855,0,932,0,3886.0
732 Crimson Leaf Ln,2019,2575,1289,1286,0,1289,0,6510.0
732 Old Timber Pass,2020,1876,978,898,0,978,0,7315.0
735 Old Timber Pass,2020,1648,838,810,0,832,0,4275.0
736 Old Timber Pass,2020,2088,1086,1002,0,1082,0,7547.0
739 Old Timber Pass,2019,1537,788,749,0,788,0,4275.0
743 Old Timber Pass,2019,1628,828,800,0,822,0,5749.0
802 Feather Sound Dr,2020,1883,985,898,0,536,360,7800.0
802 Silas St,2020,2244,1122,1122,0,1122,0,8725.0
805 Feather Sound Dr,2020,1694,1694,0,0,1694,0,5209.0
808 Feather Sound Dr,2020,1841,1841,0,0,1841,1108,7800.0
809 Feather Sound Dr,2020,1532,788,744,0,788,0,3891.0
810 Silas St,2020,1996,1148,848,0,1138,0,7695.0
811 Silas St,2020,1780,862,918,0,862,0,3515.0
813 Feather Sound Dr,2020,1510,772,738,0,772,0,3891.0
814 Feather Sound Dr,2020,1580,1580,0,0,1580,0,7800.0
815 Silas St,2020,1672,907,765,0,907,204,3515.0
816 Royster Oaks Dr,2019,1176,1176,0,0,1176,700,3524.0
816 Silas St,2019,1588,1588,0,0,1588,1237,7697.0
817 Feather Sound Dr,2020,1542,788,754,0,788,454,3891.0
820 Feather Sound Dr,2020,2052,1006,1046,0,1006,0,7800.0
821 Feather Sound Dr,2020,1806,908,898,0,902,389,4732.0
822 Silas St,2020,1593,783,810,0,783,0,7698.0
822 West Shore Dr,2019,1900,990,910,0,910,723,5195.0
823 Silas St,2020,1224,1224,0,0,1224,550,3515.0
825 Feather Sound Dr,2020,1541,797,744,0,788,0,3987.0
826 Feather Sound Dr,2020,2084,1082,1002,0,1082,0,7788.0
828 Royster Oaks Dr,2020,1847,897,950,0,885,0,3528.0
829 Feather Sound Dr,2020,1520,782,738,0,782,458,3981.0
831 Royster Oaks Dr,2019,1705,1705,0,0,1705,0,6470.0
832 Feather Sound Dr,2020,1881,978,903,0,978,0,7055.0
833 Feather Sound Dr,2020,1787,932,855,0,932,519,4193.0
834 Silas St,2020,1958,1007,951,0,1007,0,7701.0
835 Silas St,2020,1224,1224,0,0,1224,930,3515.0
837 Feather Sound Dr,2020,1787,932,855,0,932,0,6653.0
840 Silas St,2019,1968,1968,0,0,1968,1812,7755.0
843 Sugar Maple Ln,2020,2045,1006,1039,0,1006,0,9148.0
847 Sugar Maple Ln,2020,1974,1974,0,0,1974,0,13493.0
848 Sugar Maple Ln,2020,1660,838,822,0,838,0,6092.0
849 Royster Oaks Dr,2020,1726,732,994,0,732,0,5730.0
851 Sugar Maple Ln,2020,2598,1422,1176,0,1422,0,9580.0
852 Sugar Maple Ln,2019,1815,917,898,0,911,514,6939.0
8525 Prairie Hill Rd,2019,2929,1666,1263,0,1045,549,38680.0
855 Sugar Maple Ln,2019,2045,1006,1039,0,1006,0,7860.0
859 Sugar Maple Ln,2020,2400,1208,1192,0,1208,0,7910.0
863 Sugar Maple Ln,2019,2213,1133,1080,0,1124,0,11494.0
867 Sugar Maple Ln,2020,2084,1082,1002,0,1082,0,6060.0
868 Sugar Maple Ln,2020,1606,770,836,0,770,0,5812.0
871 Sugar Maple Ln,2019,2498,1312,1186,0,1312,0,7817.0
872 Sugar Maple Ln,2019,1876,978,898,0,978,696,6759.0
876 Sugar Maple Ln,2019,1650,828,822,0,828,0,6152.0
904 Cherry Bark Rd,2020,2069,1030,1039,0,1030,0,8095.0
904 Sugar Maple Ln,2019,1502,763,739,0,763,0,5900.0
908 Sugar Maple Ln,2020,1584,1584,0,0,1584,898,5900.0
911 Sugar Maple Ln,2020,1881,978,903,0,978,0,6000.0
912 Cherry Bark Rd,2020,2413,1231,1182,0,1231,543,6500.0
912 Sugar Maple Ln,2020,2056,1068,988,0,1068,480,6762.0
915 Sugar Maple Ln,2019,1582,798,784,0,790,0,6528.0
916 Cherry Bark Rd,2020,2045,1006,1039,0,1006,544,6500.0
916 Sugar Maple Ln,2019,1749,1749,0,0,1745,0,6841.0
919 Sugar Maple Ln,2019,1519,777,742,0,777,0,7285.0
920 Cherry Bark Rd,2020,2400,1208,1192,0,1208,733,6500.0
920 Sugar Maple Ln,2019,1572,1572,0,0,1572,0,6841.0
923 Sugar Maple Ln,2020,2088,1086,1002,0,1086,0,6849.0
927 Sugar Maple Ln,2020,1511,773,738,0,773,0,6942.0
928 Sugar Maple Ln,2019,1412,1412,0,0,1412,0,5900.0
931 Sugar Maple Ln,2020,1876,978,898,0,978,0,7441.0
9314 Cobalt St,2020,2261,2261,0,0,2261,1153,8770.0
9314 Highland Gate Way,2020,1520,782,738,0,782,0,3515.0
9319 Watts Rd,2020,1806,908,898,0,902,0,5527.0
932 Sugar Maple Ln,2020,1416,1416,0,0,1416,0,6106.0
9323 Watts Rd,2020,1532,788,744,0,788,0,4563.0
9326 Highland Gate Way,2020,1510,772,738,0,772,0,3515.0
9327 Highland Gate Way,2020,1628,800,828,0,794,0,3700.0
9328 Watts Rd,2020,2043,1055,988,0,1055,0,5643.0
9330 Highland Gate Way,2020,1526,782,744,0,782,0,3515.0
9331 Watts Rd,2020,1806,908,898,0,902,0,5427.0
9334 Highland Gate Way,2020,1541,797,744,0,788,0,3515.0
9335 Highland Gate Way,2020,1708,1708,0,0,1708,0,4500.0
9335 Watts Rd,2020,1787,932,855,0,932,0,4471.0
9336 Watts Rd,2019,1638,838,800,0,822,0,5150.0
9338 Highland Gate Way,2020,1787,932,855,0,932,0,4018.0
9339 Highland Gate Way,2019,1520,782,738,0,772,0,3700.0
9339 Watts Rd,2019,1511,772,739,0,772,0,4950.0
9340 Watts Rd,2020,1526,782,744,0,782,0,5099.0
9341 Honey Elm Ln,2019,1713,1713,0,0,1709,915,4817.0
9343 Highland Gate Way,2020,1511,772,739,0,772,0,3700.0
9343 Watts Rd,2020,1628,828,800,0,822,0,4070.0
9344 Watts Rd,2020,1806,908,898,0,902,0,5098.0
9345 Honey Elm Ln,2019,1537,788,749,0,788,0,3515.0
9347 Highland Gate Way,2019,1656,1656,0,0,1656,0,4500.0
9347 Watts Rd,2019,1542,793,749,0,788,0,4950.0
9348 Sleepy Pond Way,2020,1656,1656,0,0,1656,1070,4275.0
9348 Watts Rd,2020,1542,788,754,0,788,0,5098.0
9349 Honey Elm Ln,2020,1504,1504,0,0,1504,0,4275.0
935 Sugar Maple Ln,2019,1660,838,822,0,838,0,7635.0
9351 Highland Gate Way,2020,2057,1055,1002,0,1055,0,3700.0
9351 Watts Rd,2020,1787,932,855,0,932,0,4950.0
9352 Sleepy Pond Way,2020,1667,845,822,0,821,336,4275.0
9352 Watts Rd,2019,1806,908,898,0,902,0,5098.0
9353 Honey Elm Ln,2020,1813,908,905,0,902,0,4275.0
9355 Highland Gate Way,2019,1924,966,958,0,966,0,4500.0
9355 Watts Rd,2020,1813,908,905,0,902,0,4950.0
9356 Sleepy Pond Way,2020,2057,1062,995,0,1062,324,4702.0
9356 Watts Rd,2020,1532,788,744,0,788,0,5098.0
9357 Honey Elm Ln,2019,1656,1656,0,0,1656,0,4817.0
9359 Highland Gate Way,2020,1836,908,928,0,908,0,4500.0
9359 Watts Rd,2019,1787,932,855,0,932,0,5366.0
9363 Highland Gate Way,2020,1716,1716,0,0,1716,0,5552.0
9373 Harvest Moon Ln,2020,1836,982,854,0,982,0,5668.0
9375 Harvest Moon Ln,2019,1526,782,744,0,772,0,3991.0
9377 Harvest Moon Ln,2020,1542,788,754,0,788,0,3703.0
9379 Harvest Moon Ln,2019,1511,772,739,0,772,0,4411.0
9381 Harvest Moon Ln,2020,1532,788,744,0,788,0,3626.0
9383 Harvest Moon Ln,2020,1673,873,800,0,867,0,5169.0
939 Sugar Maple Ln,2019,1848,964,884,0,964,0,11270.0
9401 Ashworth Dr,2019,2488,2488,0,0,2488,1044,15695.0
9404 Ashworth Dr,2020,2230,2230,0,0,2230,918,11583.0
9413 Ashworth Dr,2019,3974,2162,1812,0,2162,1266,15366.0
9424 Wilrich St,2020,2152,1116,1036,0,1108,0,9049.0
9425 Cobalt St,2020,2427,1211,1216,0,1211,0,8301.0
945 E Dayton St,2020,1536,768,768,0,768,0,4365.0
9510 Wild Prairie Trl,2019,1773,1773,0,0,1773,0,13200.0
9521 Wild Prairie Trl,2019,1980,960,1020,0,960,0,9608.0
9525 Wild Prairie Trl,2019,2257,1189,1068,0,1189,588,9608.0
9532 Lost Pine Trl,2019,2287,2287,0,0,2287,192,9434.0
9562 Dregers Way,2020,2320,2320,0,0,2320,784,8394.0
9605 Sandhill Rd,2019,2236,2236,0,0,2236,1664,11812.0
9618 Grey Kestrel Dr,2020,2319,1149,1170,0,1149,773,7370.0
9629 Grey Kestrel Dr,2020,1897,1897,0,0,1897,550,7976.0
9633 Winter Basil Dr,2020,1580,1580,0,0,1572,0,7080.0
9634 Winter Basil Dr,2020,1848,964,884,0,964,0,6484.0
9637 Shadow Ridge Trl,2019,2539,1439,1100,0,1439,1056,12840.0
9637 Winter Basil Dr,2020,1580,1580,0,0,1572,0,8040.0
9652 Tawny Acorn Dr,2020,2421,1245,1176,0,1245,543,11069.0
9703 Winter Basil Dr,2020,1572,1572,0,0,1572,0,8040.0
9704 Tawny Acorn Dr,2020,2211,2211,0,0,2211,958,13094.0
9704 Winter Basil Dr,2020,1815,917,898,0,911,0,7298.0
9707 Winter Basil Dr,2020,1482,1482,0,0,1482,0,7924.0
9708 Sweet Autumn Dr,2019,1864,964,900,0,964,0,5900.0
9708 Tawny Acorn Dr,2020,2777,1385,1392,0,1385,0,12367.0
9711 Gilded Cider Blvd,2019,2124,1122,1002,0,1118,0,5900.0
9711 Winter Basil Dr,2020,1880,978,902,0,978,0,9325.0
9712 Tawny Acorn Dr,2020,2400,1208,1192,0,1208,0,12800.0
9713 Ashworth Dr,2019,1933,1933,0,0,1933,838,9000.0
9713 Sweet Autumn Dr,2019,1879,981,898,0,978,375,7000.0
9715 Winter Basil Dr,2020,1848,964,884,0,964,0,13011.0
9716 Sweet Autumn Dr,2019,1572,1572,0,0,1572,0,5900.0
9716 Tawny Acorn Dr,2020,2919,1614,1305,0,1601,437,12800.0
9717 Sweet Autumn Dr,2019,1967,1967,0,0,1967,0,7000.0
9717 Tawny Acorn Dr,2020,2503,1317,1186,0,1317,0,9139.0
9719 Gilded Cider Blvd,2019,2056,1068,988,0,1068,0,5900.0
9719 Winter Basil Dr,2020,2446,1188,1258,0,1188,0,11252.0
9720 Tawny Acorn Dr,2020,2780,1390,1390,0,1390,0,12800.0
9720 Winter Basil Dr,2020,2045,1006,1039,0,1006,539,7744.0
9721 Tawny Acorn Dr,2019,2782,1391,1391,0,1391,507,7338.0
9723 Gilded Cider Blvd,2019,1503,763,740,0,763,0,5900.0
9723 Tiercel Dr,2020,1722,1722,0,0,1722,485,8752.0
9723 Winter Basil Dr,2020,1502,763,739,0,763,0,6815.0
9724 Sweet Autumn Dr,2019,1502,763,739,0,763,0,5900.0
9724 Tawny Acorn Dr,2020,2790,1392,1398,0,1392,0,16643.0
9724 Tiercel Dr,2020,1640,1640,0,0,1640,936,7360.0
9724 Winter Basil Dr,2020,1511,773,738,0,773,0,5900.0
9725 Sweet Autumn Dr,2019,2284,1164,1120,0,1164,0,7100.0
9725 Tawny Acorn Dr,2020,2212,1128,1084,0,1128,0,7762.0
9727 Gilded Cider Blvd,2019,1645,833,812,0,828,0,5900.0
9727 Winter Basil Dr,2020,1883,985,898,0,978,0,5919.0
9728 Tawny Acorn Dr,2020,3459,1743,1716,0,1743,0,12806.0
9728 Winter Basil Dr,2020,1572,1572,0,0,1572,648,5900.0
9729 Tawny Acorn Dr,2019,1555,763,792,0,763,0,6353.0
9730 Ashworth Dr,2019,1610,1610,0,0,1610,423,12348.0
9731 Tiercel Dr,2019,2149,2149,0,0,2149,0,8601.0
9731 Winter Basil Dr,2020,1660,838,822,0,1660,0,5900.0
9732 Winter Basil Dr,2020,1482,1482,0,0,1482,0,5900.0
9733 Ashworth Dr,2019,1819,1819,0,0,1819,952,12048.0
9735 Winter Basil Dr,2020,2056,1068,988,0,1068,0,5900.0
9738 Winter Basil Dr,2020,1583,806,777,0,806,0,5910.0
9739 Winter Basil Dr,2020,2084,1082,1002,0,1082,0,5900.0
9743 Watts Rd,2019,1480,746,734,0,740,0,3181.0
9743 Winter Basil Dr,2019,1519,777,742,0,777,0,6719.0
9745 Watts Rd,2019,1480,746,734,0,740,0,3181.0
9801 Tiercel Dr,2019,2670,1248,1422,0,1248,0,8915.0
9804 Sunny Spring Dr,2019,2092,1086,1006,0,1082,0,6952.0
9808 Sunny Spring Dr,2019,1692,1692,0,0,1692,380,6500.0
9813 Sunny Spring Dr,2019,2049,1010,1039,0,1010,0,8359.0
9825 Cape Silver Way,2020,2822,1444,1378,0,1446,758,12032.0
9831 Sunny Spring Dr,2019,1812,1812,0,0,1812,0,8549.0
9835 Sunny Spring Dr,2020,1983,1983,0,0,1983,0,8287.0
9901 Sweet Willow Pass,2019,1815,917,898,0,911,0,8388.0
9905 Sweet Willow Pass,2020,1728,1728,0,0,1728,690,5995.0
9909 Sweet Willow Pass,2020,1566,790,776,0,790,0,5100.0
9911 Peach Leaf Ln,2020,2484,1183,1301,0,1183,0,12000.0
9912 White Fox Ln,2020,2228,2228,0,0,2228,1311,11394.0
9913 Cape Silver Way,2020,2245,1151,1094,0,1151,0,9845.0
9913 Sweet Willow Pass,2020,1596,797,799,0,797,0,5100.0
9915 Peach Leaf Ln,2020,2045,2045,0,0,2045,0,12000.0
9915 White Fox Ln,2019,2260,1166,1094,0,1166,720,15385.0
9916 White Fox Ln,2019,1631,1631,0,0,1631,796,10556.0
9917 Cape Silver Way,2020,2051,2051,0,0,2051,0,8760.0
9917 Sweet Willow Pass,2020,1574,790,784,0,790,0,5100.0
9919 White Fox Ln,2019,2525,1698,827,0,1698,889,10140.0
9920 White Fox Ln,2019,2060,2060,0,0,2060,936,8931.0
9921 Cape Silver Way,2020,2245,1151,1094,0,1151,0,8909.0
9923 White Fox Ln,2019,1962,1058,904,0,1058,0,10855.0
9924 White Fox Ln,2019,2554,1231,1323,0,1219,0,8931.0
9925 Cape Silver Way,2020,2477,1176,1301,0,1176,0,7284.0
9928 White Fox Ln,2020,1694,1694,0,0,1694,0,8931.0
9929 Cape Silver Way,2019,1952,1053,899,0,1053,0,7284.0
9930 Cape Silver Way,2020,2149,2149,0,0,2149,0,9415.0
9932 White Fox Ln,2020,2051,2051,0,0,2051,1084,9754.0
9933 Cape Silver Way,2020,2002,1103,899,0,1103,0,7284.0
9936 White Fox Ln,2019,2491,1196,1295,0,1196,941,8463.0
9937 Cape Silver Way,2020,1735,866,869,0,866,537,7774.0
9940 White Fox Ln,2019,1813,1813,0,0,1813,0,7556.0
9944 White Fox Ln,2020,2477,1176,1301,0,1176,0,8022.0
